###########################
                       ####
                ####
##########   #######    ###
###              ####   ###
##  ################  #####
##  ############         ##
##  #####           #######
##      ######
##    ################  ###
#####     #######         #
########                ###
####      ########
#####    ##########    ####
###########################