
Mapa snake:
###########################
                       ####
                ####
##########   #######    ###
###              ####   ###
##  ################  #####
##  ############         ##
##  #####           #######
##      ######
##    ################  ###
#####     #######         #
########                ###
####      ########
#####    ##########       #
###########################


Mapa Pokemon:
#############################################
#   @                                       #
#                                           #
#  #########                                #
#                                           #
#              ################             #
#              ############                 #
#              #####                        #
#                   ######                  #
#               ################            #
#                                           #
#                                           #
#                                           #
#    ########           ##################  #
#                                           #
#                                           #
#           ###########                     #
#############################################



   #########

               ################
               ############
               #####
                    ######
                ################



     ########           ##################


            ###########